#################################################
#........#.#..........................#.........#
#........###....##..........##........#.........#
#........#......##....................#.........#
#........#......................K...............#
#........................@.....................#
#........#..................##........#.........#
#........#......##..........##........#.........#
#........#......##..........##........#.........#
#################################################