#################################################
#........#.#..........................#.........#
#........###....##..........##........#.........#
#........#......##....................#.........#
#........#......................................#
#@..............................................#
#........#..K...............##........#.........#
#........#......##..........##........#.........#
#........#......##..........##........#.........#
#################################################