#################################################
#........#.#..........................#.........#
#........###....##..........##........#.........#
#........#......##..........##........#.........#
#........#............................#.........#
#@..............................................#
#........#..................##........#.........#
#........#......##..........##........#.........#
#........#......##..........##........#.........#
#################################################