#################################################
#........#.#..........................#.........#
#........###....##..........##....B...#.........#
#........#......##....................#.........#
#........#......................................#
#@...B..........................................#
#........#..K............B..##........#.........#
#........#......##..........##........#.........#
#........#......##..........##........#.........#
#################################################