#################################################
#........#.#..................K.......#.........#
#........###....##..........##........#.........#
#..K.....#......##....................#.........#
#........#........................K.............#
#@..............................................#
#........#..K...............##........#.........#
#........#......##..........##........#.........#
#........#......##..........##........#.........#
#################################################